PLATE_ID,COPIES,NODE_ID,X,Y,WIDTH,HEIGHT,TYPE,CUT,PARENT
0,1,0,0,0,10,10,0,0,
0,1,1,0,0,10,10,-2,1,0
0,1,2,0,0,10,4,-2,2,1
0,1,3,0,0,10,4,0,3,2
0,1,4,0,4,10,6,-2,2,1
0,1,5,0,4,6,6,1,3,4
0,1,6,6,4,4,6,2,3,4
