PLATE_ID,COPIES,NODE_ID,X,Y,WIDTH,HEIGHT,TYPE,CUT,PARENT
0,1,0,0,0,10,10,0,0,
0,1,1,0,0,10,10,-2,1,0
0,1,2,0,0,10,4,0,2,1
0,1,3,0,4,10,6,-2,2,1
0,1,4,0,4,6,6,1,3,3
0,1,5,6,4,4,6,-1,3,3
1,1,6,0,0,10,10,0,0,
1,1,7,0,0,4,10,-2,1,6
1,1,8,0,0,4,6,2,2,7
1,1,9,0,6,4,4,-1,2,7
1,1,10,4,0,6,10,-3,1,6
